Copy paste these maps:

MAP 1

00010000000000000000000000000000000000000000000000
00010000000000000000000000000000000000000000000000
00010000000000000000000000000000000000000000000000
00010000000000000000000000000000000000000000000000
00010000000000000000000000000000000000000000000000
00010000000000000000000000000000000100000000000000
00010000000000000000000000000000000100000000000000
00010000000000000000000000000000000100000011111111
00010000000000000000000000000000000100000000000000
00010000000000000000000000000000000100000000000000
00011111111111111111111100011111111111111111000000
00010000000000100000001000000100000100000000000000
00010000000000100000001000000100000100000000000000
00010000000000111110001000000111000111111111111111
00010000000000100000001110000001000000000000000000
00010000000000100000000010000001000000000000000000
00011111100000100000000010000001000000000000000000
00010000000000100010000011100001110000000000000000
00010000000000100010000000100000000000000000000000
00010000000000100010000000110000000000000000000000
00010000000000100011111100010000000000000000000000
00010000011111100000000100011111110000000000000000
00000000000001000000000000000000000000000000000000
00000000000001000000000000000000000000000000000000
00000000000000000111110000000000000000000000000000
00000000000000000100011111111100000000000000000000
00000000011111111100000000000000000000000000000000
00000000000000000100000000000000000000000000000000
00000000000000000000000000000000000000000000000000
00000000000000000000000000000000000000000000000000
00000000000000000000000000000000000000000000000000
00000000000000000000000000000000000000000000000000
00000000000000000000000000000000000000000000000000
00000000000000000000000000000000000000000000000000
00000000000000000000000000000000000000000000000000
00000000000000000000000000000000000000000000000000
00000000000000000000000000000000000000000000000000
00000000000000000000000000000000000000000000000000
00000000000000000000000000000000000000000000000000
00000000000000000000000000000000000000000000000000
00000000000000000000000000000000000000000000000000
00011111111111111111111100011111111111111111100000
00000000000000000100000000000000000000000000000000
00000000011100000100000000000000000000000000000000
00000000010000000100000000000000000000000000000000
00000000010000000100000000000000000000000000000000
00000000010000000100000000000000000000000000000000
00000000010000000100000000000000000000000000000000
00000000010000000000000000000000000000000000000000
00000000010000000000000000000000000000000000000000

